%%%%%%%%%%%%%%%%%%%%%%%%%%%%%%%%%%%%%%%%%%%%%%%%%%%%%%%%%%%%%
%         % %           %     %           %...........%.....%
% %%%% %% % % %%%%% %%%%% %%% % %%%% %% %%%.%% %% %%%.%.% % %
% %     %   %     %       %   %       %.....%   % % %...% % %
% % %%% % %%%% %% %%%%%%%%% %%%%% %%% %.%%% % % % % %%%%% % %
% %   %   %       %       %       %   %.  % % % %     %   % %
% % %%% %%% %%% %%% % %%% %%%% %% % %%%.% %%% % %%% %%% %%% %
%   %     %     %   % %.........% % %...%     %   % %   % % %
% %%% %%% %%%%% %%%%% %.%%% %%%.%%%%%.%%%%%% %%%% %%% %%% % %
%     %.......%    .....% % %  .......%   %     %     %   % %
% %%%%%.%%%%%.%%%%%.%%% % % % %%%%%%%%% % % %%% %%% %%% %%% %
% %   %.%   %.......  % %   % %     %   % % %           %   %
% % %%%.% %%% %%%%% % % %%%%% % % %%% % % %%% %%%%% %%%%% %%%
%   %...% %       % % %   %   % %   % % %     %     %   % % %
% %%%.%%% % % %%% %%% %%% % %%% %%% % % %%%%%%%%% %%% % % % %
% %...%   % %   %   % %   % %     %   %   %     % %   %   % %
%...%%% % % % % % % % % %%% % %%%%%%% %%% % %%% % % %%%%%%% %
%.%   % %   % %   %   % %                 % %   % % %       %
%.%%% %%% %%% %%% % %%% % %%% % %%%%%% %%%% % %%%%% % % %%% %
%...%         %   % %   % %   %         %   % %     % % %   %
%%%.%%% % %%%%% %%%%% %%%%% %%% %%%%%%% % %%% % %%%%%%% % %%%
%P..  %       %             %         %     %           %   %
%%%%%%%%%%%%%%%%%%%%%%%%%%%%%%%%%%%%%%%%%%%%%%%%%%%%%%%%%%%%%
94